..............####
..................
..S...............
..................
#.................
#.................
#.............####
#.................
#.................
#.................
##....#...........
##....#...........
##....#...........
##....#...........