....#...............
..S.#.####.####.###.
......#.........#...
.####.#.####c####.#.
.#.........#......#.
.#.#.#####.#.####.#.
.#.#................
.#.#.#.######.#.###.
.....#........#.....
####.#.#.#.##.#.###.
#...c..#.#.#..#...#.
#.######.#.#.####.#.
..............#...#.
.#.#.###.#.##.#.###.
.#.#......c.#.......
.#.#.####.#.#.......
.#...#..............
.###.#####.##.......
....................
