#########################
#D#...................D##
#.#.#################.###
#.#.#c.............c#.#c#
#.#.#.#############.#.#.#
#...#.......S.......#...#
#########################