#############
######.######
######.######
####....c####
###.##.##.###
###.##.##.###
#.....S.....#
###.##.##.###
###.##.##.###
####D....####
######.######
######.######
#############
#############
#######S..###
#######Sccc##
#######S...D#