################
.....c#####.....
.####c#####D####
.####.#####c.###
#####.######.###
###....###...###
##c.##.###.#####
######..#..#####
#######.#.######
######.....#####
######..S..#####
################
################
#########S...c##
#########S..ccc#
#########S...ccD