.......................###............##
.......................#................
.......................#................
................##.....#................
.......................#................
........................................
........................................
........................................
...................................##...
....................................#...
....................................##..
................#.......................
...............###......................
....#...........#.......................
...##.....................##............
.....................S....#........##...
........................................
........................................
...........................##...........
...........................##...........
........................................
........................................
........................................
........................................
...............................###......
..............................#####.....
..........#................####...###...
........................................
........................................
........................................
................................##......
...............................###......
...............................###......
...............................##.......
#.......................................
########################################
########################################
Sccccccc..............................##
SDDDDDDDDD.............................#
SDDDDDDDDDDDDDDDDDDccc..................
