S...................
....................
....................
....................
....................
....................
....................
....................
....................
....................
####################
####################
####################
S..............cD###
S..............DDD##
S..............DDDD#
