99999999999999999999999999
99999999999999999999999999
77777777777777777777777777
44444444444444444444444444
33333333333333333333333333
33333333333333333333333333
..........................
..S.......................
..........................
33333333333333333333333333
33333333333333333333333333
44444444444444444444444444
77777777777777777777777777
99999999999999999999999999
99999999999999999999999999
##########################
##########################
####S..........DDD########
####S.........DDDDD#######
####S........DDDDDDD######
