#########################
#S......................#
#.......................#
#.......................#
#.........#####.........#
#.........#####.........#
#.......................#
#.......................#
#.......................#
#########################