#########################
#S......................#
#######################.#
#c......................#
#.#######################
#......................D#
#######################.#
#c......................#
#.#######################
#......................D#
#########################