#########........#
#########.######.#
#########.######.#
#########.######.#
#########.######.#
#########.######.#
#................#
#.#######.########
#.#######.########
#.#######.########
#.#######.########
#S........########
##################
##################
##################
S.......##########
S.......D#########
S......ccc########
