##################
##################
##..............##
##.###############
##.###############
##S.............##
###############.##
###############.##
##..............##
##################
##################
##################
S.......##########
S......cc#########
S.......cc########
