##################
###............###
##..##########..##
##.############.##
##.############.##
##.############.##
##.############.##
##..##########..##
###.....S......###
##################
##################
##################
S.......##########
S......cc#########
S........D########
