####################
#S#D............D#S#
#.#.##########.###.#
#.#.#c...#...#.#.#.#
#.#.#.##.#.#.#.#.#.#
#.#.#.##.77.##.#.#.#
#.#.#.#......#.#.#.#
#...#...####...#...#
#####.#######.######
#..................#
#####.#######.######
#...#...####...#...#
#.#.#.#......#.#.#.#
#.#.#.##.77.##.#.#.#
#.#.#.#.#.#.##.#.#.#
#.#.#c...#...#.#.#.#
#.#.##########.###.#
#S#D............D#S#
####################
