##############################
#S..........................S#
#............................#
#...###....c....c....###.....#
#...#D#..............#D#.....#
#...###....###..###..###.....#
#..........#......#..........#
#...c......#..DD..#......c...#
#...c......#..DD..#......c...#
#..........#......#..........#
#...###....###..###..###.....#
#...#D#..............#D#.....#
#...###....c....c....###.....#
#............................#
#S..........................S#
##############################